DNA	DNA ELEMENTS	D-OTHER
DNA	DNA ELEMENTS	D-OTHER
DNA_Academ	DNA ELEMENTS	D-OTHER
DNA_Chapaev	DNA ELEMENTS	D-OTHER
DNA_CMC-Chapaev-3	DNA ELEMENTS	D-OTHER
DNA_CMC-EnSpm	DNA ELEMENTS	D-OTHER
DNA_CMC-EnSpm?	DNA ELEMENTS	D-OTHER
DNA_CMC-Transib	DNA ELEMENTS	D-OTHER
DNA_En-Spm	DNA ELEMENTS	D-OTHER
DNA_Harbinger	DNA ELEMENTS	D-OTHER
DNA_hAT	DNA ELEMENTS	hAT
DNA_hAT-Ac	DNA ELEMENTS	hAT
DNA_hAT-Ac?	DNA ELEMENTS	hAT
DNA_hAT-Blackjack	DNA ELEMENTS	hAT
DNA_hAT-Charlie	DNA ELEMENTS	hAT
DNA_hAT-hobo?	DNA ELEMENTS	hAT
DNA_hAT-Tip100	DNA ELEMENTS	hAT
DNA_hAT-Tip100?	DNA ELEMENTS	hAT
DNA_hAT-Tol2	DNA ELEMENTS	hAT
DNA_hAT?	DNA ELEMENTS	hAT
DNA_Kolobok	DNA ELEMENTS	D-OTHER
DNA_Kolobok-T2	DNA ELEMENTS	D-OTHER
DNA_Kolobok-T2?	DNA ELEMENTS	D-OTHER
DNA_Maverick	DNA ELEMENTS	D-OTHER
DNA_Merlin	DNA ELEMENTS	D-OTHER
DNA_MULE-MuDR	DNA ELEMENTS	D-OTHER
DNA_MULE-MuDR?	DNA ELEMENTS	D-OTHER
DNA_P	DNA ELEMENTS	D-OTHER
DNA_P?	DNA ELEMENTS	D-OTHER
DNA_PIF-Harbinger	DNA ELEMENTS	D-OTHER
DNA_PIF-Harbinger?	DNA ELEMENTS	D-OTHER
DNA_PIF-ISL2EU	DNA ELEMENTS	D-OTHER
DNA_PiggyBac	DNA ELEMENTS	D-OTHER
DNA_PiggyBac?	DNA ELEMENTS	D-OTHER
DNA_T2	DNA ELEMENTS	Tc-Group
DNA_TcMar	DNA ELEMENTS	Tc-Group
DNA_TcMar-Fot1	DNA ELEMENTS	Tc-Group
DNA_TcMar-ISRm11	DNA ELEMENTS	Tc-Group
DNA_TcMar-Mariner	DNA ELEMENTS	Tc-Group
DNA_TcMar-Pogo	DNA ELEMENTS	Tc-Group
DNA_TcMar-Stowaway?	DNA ELEMENTS	Tc-Group
DNA_TcMar-Tc1	DNA ELEMENTS	Tc-Group
DNA_TcMar-Tc2	DNA ELEMENTS	Tc-Group
DNA_TcMar-Tigger	DNA ELEMENTS	Tc-Group
DNA_TcMar?	DNA ELEMENTS	Tc-Group
DNA_Transib	DNA ELEMENTS	D-OTHER
DNA?	DNA ELEMENTS	D-OTHER
DNA/Academ	DNA ELEMENTS	D-OTHER
DNA/Chapaev	DNA ELEMENTS	D-OTHER
DNA/CMC-Chapaev-3	DNA ELEMENTS	D-OTHER
DNA/CMC-EnSpm	DNA ELEMENTS	D-OTHER
DNA/CMC-EnSpm?	DNA ELEMENTS	D-OTHER
DNA/CMC-Transib	DNA ELEMENTS	D-OTHER
DNA/En-Spm	DNA ELEMENTS	D-OTHER
DNA/En-Spm?	DNA ELEMENTS	D-OTHER
DNA/Harbinger	DNA ELEMENTS	D-OTHER
DNA/hAT	DNA ELEMENTS	hAT
DNA/hAT-Ac	DNA ELEMENTS	hAT
DNA/hAT-Ac?	DNA ELEMENTS	hAT
DNA/hAT-Blackjack	DNA ELEMENTS	hAT
DNA/hAT-Blackjack?	DNA ELEMENTS	hAT
DNA/hAT-Charlie	DNA ELEMENTS	hAT
DNA/hAT-hAT5	DNA ELEMENTS	hAT
DNA/hAT-hobo?	DNA ELEMENTS	hAT
DNA/hAT-Tip100	DNA ELEMENTS	hAT
DNA/hAT-Tip100?	DNA ELEMENTS	hAT
DNA/hAT-Tol2	DNA ELEMENTS	hAT
DNA/hAT?	DNA ELEMENTS	hAT
DNA/Kolobok	DNA ELEMENTS	D-OTHER
DNA/Kolobok-T2	DNA ELEMENTS	D-OTHER
DNA/Kolobok-T2?	DNA ELEMENTS	D-OTHER
DNA/Maverick	DNA ELEMENTS	D-OTHER
DNA/Merlin	DNA ELEMENTS	D-OTHER
DNA/MuDR	DNA ELEMENTS	D-OTHER
DNA/MULE-MuDR	DNA ELEMENTS	D-OTHER
DNA/P	DNA ELEMENTS	D-OTHER
DNA/P?	DNA ELEMENTS	D-OTHER
DNA/PIF-Harbinger	DNA ELEMENTS	D-OTHER
DNA/PIF-Harbinger?	DNA ELEMENTS	D-OTHER
DNA/PIF-ISL2EU	DNA ELEMENTS	D-OTHER
DNA/PiggyBac	DNA ELEMENTS	D-OTHER
DNA/PiggyBac?	DNA ELEMENTS	D-OTHER
DNA/Sola	DNA ELEMENTS	D-OTHER
DNA/T2	DNA ELEMENTS	D-OTHER
DNA/TcMar	DNA ELEMENTS	Tc-Group
DNA/TcMar-Fot1	DNA ELEMENTS	Tc-Group
DNA/TcMar-ISRm11	DNA ELEMENTS	Tc-Group
DNA/TcMar-Mariner	DNA ELEMENTS	Tc-Group
DNA/TcMar-Pogo	DNA ELEMENTS	Tc-Group
DNA/TcMar-Stowaway?	DNA ELEMENTS	Tc-Group
DNA/TcMar-Tc1	DNA ELEMENTS	Tc-Group
DNA/TcMar-Tc2	DNA ELEMENTS	Tc-Group
DNA/TcMar-Tigger	DNA ELEMENTS	Tc-Group
DNA/TcMar?	DNA ELEMENTS	Tc-Group
DNA/Transib	DNA ELEMENTS	D-OTHER
DNA/Zator	DNA ELEMENTS	D-OTHER
LINE_CR1	LINEs	CR1
LINE_CR1?	LINEs	CR2
LINE_Dong-R4	LINEs	L-OTHER
LINE_I	LINEs	L-OTHER
LINE_Jockey	LINEs	L-OTHER
LINE_L1	LINEs	L[1-2]
LINE_L1-Tx1	LINEs	L[1-2]
LINE_L1?	LINEs	L[1-2]
LINE_L2	LINEs	L[1-2]
LINE_Penelope	LINEs	L-OTHER
LINE_R2	LINEs	L-OTHER
LINE_R2-Hero	LINEs	L-OTHER
LINE_Rex-Babar	LINEs	L-OTHER
LINE_RTE	LINEs	RTE
LINE_RTE-BovB	LINEs	RTE
LINE_RTE-RTE	LINEs	RTE
LINE_RTE-X	LINEs	RTE
LINE?	LINEs	L-OTHER
LINE?_Penelope?	LINEs	L-OTHER
LINE?/Penelope?	LINEs	L-OTHER
LINE/CR1	LINEs	CR1
LINE/CR1?	LINEs	CR1
LINE/Dong-R4	LINEs	L-OTHER
LINE/I	LINEs	L-OTHER
LINE/Jockey	LINEs	L-OTHER
LINE/L1	LINEs	L[1-2]
LINE/L1-Tx1	LINEs	L[1-2]
LINE/L1?	LINEs	L[1-2]
LINE/L2	LINEs	L[1-2]
LINE/Penelope	LINEs	L-OTHER
LINE/R2	LINEs	L-OTHER
LINE/R2-Hero	LINEs	L-OTHER
LINE/Rex-Babar	LINEs	L-OTHER
LINE/RTE	LINEs	RTE
LINE/RTE-BovB	LINEs	RTE
LINE/RTE-RTE	LINEs	RTE
LINE/RTE-X	LINEs	RTE
Low_complexity	SKIP THESE	SKIP THESE
LTR	LTR ELEMENTS	LTR
LTR_Copia	LTR ELEMENTS	LTR
LTR_Copia(Xen1)	LTR ELEMENTS	LTR
LTR_DIRS	LTR ELEMENTS	LTR
LTR_ERV	LTR ELEMENTS	ERV
LTR_ERV-Foamy	LTR ELEMENTS	ERV
LTR_ERV-Lenti	LTR ELEMENTS	ERV
LTR_ERV1	LTR ELEMENTS	ERV
LTR_ERVK	LTR ELEMENTS	ERV
LTR_ERVK?	LTR ELEMENTS	ERV
LTR_ERVL	LTR ELEMENTS	ERV
LTR_ERVL-MaLR	LTR ELEMENTS	ERV
LTR_ERVL?	LTR ELEMENTS	ERV
LTR_Gypsy	LTR ELEMENTS	LTR
LTR_Gypsy?	LTR ELEMENTS	LTR
LTR_Ngaro	LTR ELEMENTS	LTR
LTR_Pao	LTR ELEMENTS	LTR
LTR?	LTR ELEMENTS	LTR
LTR/Copia	LTR ELEMENTS	LTR
LTR/Copia(Xen1)	LTR ELEMENTS	LTR
LTR/DIRS	LTR ELEMENTS	LTR
LTR/ERV	ERVs	ERV
LTR/ERV-Foamy	ERVs	ERV
LTR/ERV-Lenti	ERVs	ERV
LTR/ERV1	ERVs	ERV
LTR/ERV1?	ERVs	ERV
LTR/ERVK	ERVs	ERV
LTR/ERVK?	ERVs	ERV
LTR/ERVL	ERVs	ERV
LTR/ERVL-MaLR	ERVs	ERV
LTR/ERVL?	ERVs	ERV
LTR/Gypsy	LTR ELEMENTS	LTR
LTR/Gypsy?	LTR ELEMENTS	LTR
LTR/Ngaro	LTR ELEMENTS	LTR
LTR/Pao	LTR ELEMENTS	LTR
Other	UNCLASSIFIED	UNC
RC_Helitron	ROLLING CIRCLES	RC
RC?_Helitron?	ROLLING CIRCLES	RC
RC?/Helitron?	ROLLING CIRCLES	RC
RC/Helitron	ROLLING CIRCLES	RC
RNA	SMALL RNAs	smRNA
rRNA	SMALL RNAs	smRNA
Satellite	SATELLITES	SAT
Satellite_centr	SATELLITES	SAT
Satellite_macro	SATELLITES	SAT
Satellite_telo	SATELLITES	SAT
Satellite_Y-chromosome	SATELLITES	SAT
Satellite?	SATELLITES	SAT
Satellite/centr	SATELLITES	SAT
Satellite/macro	SATELLITES	SAT
Satellite/telo	SATELLITES	SAT
Satellite/W-chromosome	SATELLITES	SAT
Satellite/Y-chromosome	SATELLITES	SAT
scRNA	SMALL RNAs	smRNA
Segmental	UNCLASSIFIED	UNC
Simple_repeat	SIMPLE REPEATS	SSR
SINE	SINEs	SINE
SINE_5S	SINEs	SINE
SINE_7SL	SINEs	SINE
SINE_Alu	SINEs	SINE
SINE_B2	SINEs	SINE
SINE_B4	SINEs	SINE
SINE_BovA	SINEs	SINE
SINE_C	SINEs	SINE
SINE_CORE	SINEs	SINE
SINE_Deu	SINEs	SINE
SINE_ID	SINEs	SINE
SINE_L2	SINEs	SINE
SINE_Mermaid	SINEs	SINE
SINE_MIR	SINEs	SINE
SINE_RTE	SINEs	SINE
SINE_RTE-BovB	SINEs	SINE
SINE_Salmon	SINEs	SINE
SINE_Sauria	SINEs	SINE
SINE_tRNA	SINEs	SINE
SINE_tRNA-7SL	SINEs	SINE
SINE_tRNA-CR1	SINEs	SINE
SINE_tRNA-Glu	SINEs	SINE
SINE_tRNA-L2	SINEs	SINE
SINE_tRNA-Lys	SINEs	SINE
SINE_tRNA-RTE	SINEs	SINE
SINE_V	SINEs	SINE
SINE?	SINEs	SINE
SINE/5S	SINEs	SINE
SINE/7SL	SINEs	SINE
SINE/Alu	SINEs	SINE
SINE/B2	SINEs	SINE
SINE/B4	SINEs	SINE
SINE/BovA	SINEs	SINE
SINE/C	SINEs	SINE
SINE/CORE	SINEs	SINE
SINE/Deu	SINEs	SINE
SINE/ID	SINEs	SINE
SINE/Mermaid	SINEs	SINE
SINE/MIR	SINEs	SINE
SINE/RTE	SINEs	SINE
SINE/RTE-BovB	SINEs	SINE
SINE/Salmon	SINEs	SINE
SINE/Sauria	SINEs	SINE
SINE/tRNA	SINEs	SINE
SINE/tRNA-7SL	SINEs	SINE
SINE/tRNA-CR1	SINEs	SINE
SINE/tRNA-Glu	SINEs	SINE
SINE/tRNA-L2	SINEs	SINE
SINE/tRNA-Lys	SINEs	SINE
SINE/tRNA-RTE	SINEs	SINE
SINE/V	SINEs	SINE
snRNA	SMALL RNAs	smRNA
srpRNA	SMALL RNAs	smRNA
tRNA	SMALL RNAs	smRNA
Unknown	UNCLASSIFIED	UNC
Unknown_Y-chromosome	UNCLASSIFIED	UNC
Unknown/Y-chromosome	UNCLASSIFIED	UNC
